#                                                                              
# TWAL mapping for the FIRST experiment of July-August 2011 - A. Le Fevre      
# cloned from S254 map with the following changes:                             
# - only 6 modules (8-packs) on the front wall                                 
# - only 6 modules on the rear wall                                            
# - no inversion of the PM ordering on the front wall                          
# FB layout:                                                                   
#	slot	2|2|2|2|2|2|1|1|1|1|1|1|1|1|1|1                                   
#		5|4|3|2|1|0|9|8|7|6|5|4|3|2|1|0|9|8|7|6|5|4|3|2|1|0               
#                                                                              
#	type	C|T|T|T|T|T|T| | | | | | | |A|A|A|A| | | | | | | |  C=CAT; T=TDC; A=ADC     
#	det	   ---tof-----------   		    		    E=EBI; B=AEB; D=Display 
#                                                                              
# slot   module    used for                                                    
#  25    CAT                                                                   
#  24    TDC       8pack  1... 4                                               
#  23    TDC       8pack  5... 8                                               
#  22    TDC       8pack  9...12                                               
#  21    TDC       8pack 13...16                                               
#  20    TDC       8pack 17...20                                               
#  19    TDC       8pack 21...24                                               
#  ..    -                                                                     
#  11    ADC       8pack  1... 6                                               
#  10    ADC       8pack  7...12                                               
#  09    ADC       8pack 13...18                                               
#  08    ADC       8pack 19...24                                               
#  ..    -                                                                     
#  00    -                                                                     
#                                                                              
# 8pack layout (beam going upwards)                                            
#                                                                              
# in relative slat number space (slat numbers within 8pack)                    
#  back :    1   2   3   4   5   6   7   8 | 1   2   3   4   5   6   7   8 | ..
#  front:      1   2   3   4   5   6   7   8 | 1   2   3   4   5   6   7   8   
#                                                                              
# in absolute slat numbers:                                                    
#  back :   101 102 103 104 105 106 107 108|109 110 111 112 113 114 115 116| ..
#  front:      1   2   3   4   5   6   7   8 | 9  10  11  12  13  14  15  16   
#                                                                              
# Note 2011-06-21:                                                             
#   In case comes the 'channel 0' problems on the first group of 16 channels   
#   of a TDC, they should be left unused. That requires one additional TDC     
#   which should host the unusable channels 0-15.                              
# Phys.  |8   |                                                                
# slat   |pack| adct| adcb  | tdct | tdcb  |Neighbour's                        
# sl|type| |PM| g|c |goe|ch |goe|ch|geo|ch | l|  r|   pl|  pr                  
#                                                                              
# front layer                                                                  
#                                                                              
   1  1   1 1  11  0  11  4  24  0  24  8    0    2  101  102
   2  1   1 2  11  8  11 12  24  1  24  9    1    3  102  103
   3  1   1 3  11  1  11  5  24  2  24 10    2    4  103  104
   4  1   1 4  11  9  11 13  24  3  24 11    3    5  104  105
   5  1   1 5  11  2  11  6  24  4  24 12    4    6  105  106
   6  1   1 6  11 10  11 14  24  5  24 13    5    7  106  107
   7  1   1 7  11  3  11  7  24  6  24 14    6    8  107  108
   8  1   1 8  11 11  11 15  24  7  24 15    7    9  108  109

   9  1   2 1  11 16  11 20  24 16  24 24    8   10  109  110
  10  1   2 2  11 24  11 28  24 17  24 25    9   11  110  111
  11  1   2 3  11 17  11 21  24 18  24 26   10   12  111  112
  12  1   2 4  11 25  11 29  24 19  24 27   11   13  112  113
  13  1   2 5  11 18  11 22  24 20  24 28   12   14  113  114
  14  1   2 6  11 26  11 30  24 21  24 29   13   15  114  115
  15  1   2 7  11 19  11 23  24 22  24 30   14   16  115  116
  16  1   2 8  11 27  11 31  24 23  24 31   15   17  116  117

  17  1   3 1  11 32  11 36  24 32  24 40   16   18  117  118
  18  1   3 2  11 40  11 44  24 33  24 41   17   19  118  119
  19  1   3 3  11 33  11 37  24 34  24 42   18   20  119  120
  20  1   3 4  11 41  11 45  24 35  24 43   19   21  120  121
  21  1   3 5  11 34  11 38  24 36  24 44   20   22  121  122
  22  1   3 6  11 42  11 46  24 37  24 45   21   23  122  123
  23  1   3 7  11 35  11 39  24 38  24 46   22   24  123  124
  24  1   3 8  11 43  11 47  24 39  24 47   23   25  124  125

  25  1   4 1  11 48  11 52  24 48  24 56   24   26  125  126
  26  1   4 2  11 56  11 60  24 49  24 57   25   27  126  127
  27  1   4 3  11 49  11 53  24 50  24 58   26   28  127  128
  28  1   4 4  11 57  11 61  24 51  24 59   27   29  128  129
  29  1   4 5  11 50  11 54  24 52  24 60   28   30  129  130
  30  1   4 6  11 58  11 62  24 53  24 61   29   31  130  131
  31  1   4 7  11 51  11 55  24 54  24 62   30   32  131  132
  32  1   4 8  11 59  11 63  24 55  24 63   31   33  132  133

  33  1   5 1  11 64  11 68  23  0  23  8   32   34  133  134
  34  1   5 2  11 72  11 76  23  1  23  9   33   35  134  135
  35  1   5 3  11 65  11 69  23  2  23 10   34   36  135  136
  36  1   5 4  11 73  11 77  23  3  23 11   35   37  136  137
  37  1   5 5  11 66  11 70  23  4  23 12   36   38  137  138
  38  1   5 6  11 74  11 78  23  5  23 13   37   39  138  139
  39  1   5 7  11 67  11 71  23  6  23 14   38   40  139  140
  40  1   5 8  11 75  11 79  23  7  23 15   39   41  140  141

  41  1   6 1  11 80  11 84  23 16  23 24   40   42  141  142
  42  1   6 2  11 88  11 92  23 17  23 25   41   43  142  143
  43  1   6 3  11 81  11 85  23 18  23 26   42   44  143  144
  44  1   6 4  11 89  11 93  23 19  23 27   43   45  144  145
  45  1   6 5  11 82  11 86  23 20  23 28   44   46  145  146
  46  1   6 6  11 90  11 94  23 21  23 29   45   47  146  147
  47  1   6 7  11 83  11 87  23 22  23 30   46   48  147  148
  48  1   6 8  11 91  11 95  23 23  23 31   47   49  148  149

  49  1   7 1  10  0  10  4  23 32  23 40   48   50  149  150
  50  1   7 2  10  8  10 12  23 33  23 41   49   51  150  151
  51  1   7 3  10  1  10  5  23 34  23 42   50   52  151  152
  52  1   7 4  10  9  10 13  23 35  23 43   51   53  152  153
  53  1   7 5  10  2  10  6  23 36  23 44   52   54  153  154
  54  1   7 6  10 10  10 14  23 37  23 45   53   55  154  155
  55  1   7 7  10  3  10  7  23 38  23 46   54   56  155  156
  56  1   7 8  10 11  10 15  23 39  23 47   55   57  156  157

  57  1   8 1  10 16  10 20  23 48  23 56   56   58  157  158
  58  1   8 2  10 24  10 28  23 49  23 57   57   59  158  159
  59  1   8 3  10 17  10 21  23 50  23 58   58   60  159  160
  60  1   8 4  10 25  10 29  23 51  23 59   59   61  160  161
  61  1   8 5  10 18  10 22  23 52  23 60   60   62  161  162
  62  1   8 6  10 26  10 30  23 53  23 61   61   63  162  163
  63  1   8 7  10 19  10 23  23 54  23 62   62   64  163  164
  64  1   8 8  10 27  10 31  23 55  23 63   63   65  164  165

  65  1   9 1  10 32  10 36  22  0  22  8   64   66  165  166
  66  1   9 2  10 40  10 44  22  1  22  9   65   67  166  167
  67  1   9 3  10 33  10 37  22  2  22 10   66   68  167  168
  68  1   9 4  10 41  10 45  22  3  22 11   67   69  168  169
  69  1   9 5  10 34  10 38  22  4  22 12   68   70  169  170
  70  1   9 6  10 42  10 46  22  5  22 13   69   71  170  171
  71  1   9 7  10 35  10 39  22  6  22 14   70   72  171  172
  72  1   9 8  10 43  10 47  22  7  22 15   71   73  172  173

  73  1  10 1  10 48  10 52  22 16  22 24   72   74  173  174
  74  1  10 2  10 56  10 60  22 17  22 25   73   75  174  175
  75  1  10 3  10 49  10 53  22 18  22 26   74   76  175  176
  76  1  10 4  10 57  10 61  22 19  22 27   75   77  176  177
  77  1  10 5  10 50  10 54  22 20  22 28   76   78  177  178
  78  1  10 6  10 58  10 62  22 21  22 29   77   79  178  179
  79  1  10 7  10 51  10 55  22 22  22 30   78   80  179  180
  80  1  10 8  10 59  10 63  22 23  22 31   79   81  180  181

  81  1  11 1  10 64  10 68  22 32  22 40   80   82  181  182
  82  1  11 2  10 72  10 76  22 33  22 41   81   83  182  183
  83  1  11 3  10 65  10 69  22 34  22 42   82   84  183  184
  84  1  11 4  10 73  10 77  22 35  22 43   83   85  184  185
  85  1  11 5  10 66  10 70  22 36  22 44   84   86  185  186
  86  1  11 6  10 74  10 78  22 37  22 45   85   87  186  187
  87  1  11 7  10 67  10 71  22 38  22 46   86   88  187  188
  88  1  11 8  10 75  10 79  22 39  22 47   87   89  188  189

  89  1  12 1  10 80  10 84  22 48  22 56   88   90  189  190
  90  1  12 2  10 88  10 92  22 49  22 57   89   91  190  191
  91  1  12 3  10 81  10 85  22 50  22 58   90   92  191  192
  92  1  12 4  10 89  10 93  22 51  22 59   91   93  192  193
  93  1  12 5  10 82  10 86  22 52  22 60   92   94  193  194
  94  1  12 6  10 90  10 94  22 53  22 61   93   95  194  195
  95  1  12 7  10 83  10 87  22 54  22 62   94   96  195  196
  96  1  12 8  10 91  10 95  22 55  22 63   95   97  196  197
#                                                                              
# back layer                                                                   
#                                                                              
 101  2  13 1   9  0   9  4  21  0  21  8  100  102    1    2
 102  2  13 2   9  8   9 12  21  1  21  9  101  103    2    3
 103  2  13 3   9  1   9  5  21  2  21 10  102  104    3    4
 104  2  13 4   9  9   9 13  21  3  21 11  103  105    4    5
 105  2  13 5   9  2   9  6  21  4  21 12  104  106    5    6
 106  2  13 6   9 10   9 14  21  5  21 13  105  107    6    7
 107  2  13 7   9  3   9  7  21  6  21 14  106  108    7    8
 108  2  13 8   9 11   9 15  21  7  21 15  107  109    8    9

 109  2  14 1   9 16   9 20  21 16  21 24  108  110    9   10
 110  2  14 2   9 24   9 28  21 17  21 25  109  111   10   11
 111  2  14 3   9 17   9 21  21 18  21 26  110  112   11   12
 112  2  14 4   9 25   9 29  21 19  21 27  111  113   12   13
 113  2  14 5   9 18   9 22  21 20  21 28  112  114   13   14
 114  2  14 6   9 26   9 30  21 21  21 29  113  115   14   15
 115  2  14 7   9 19   9 23  21 22  21 30  114  116   15   16
 116  2  14 8   9 27   9 31  21 23  21 31  115  117   16   17

 117  2  15 1   9 32   9 36  21 32  21 40  116  118   17   18
 118  2  15 2   9 40   9 44  21 33  21 41  117  119   18   19
 119  2  15 3   9 33   9 37  21 34  21 42  118  120   19   20
 120  2  15 4   9 41   9 45  21 35  21 43  119  121   20   21
 121  2  15 5   9 34   9 38  21 36  21 44  120  122   21   22
 122  2  15 6   9 42   9 46  21 37  21 45  121  123   22   23
 123  2  15 7   9 35   9 39  21 38  21 46  122  124   23   24
 124  2  15 8   9 43   9 47  21 39  21 47  123  125   24   25

 125  2  16 1   9 48   9 52  21 48  21 56  124  126   25   26
 126  2  16 2   9 56   9 60  21 49  21 57  125  127   26   27
 127  2  16 3   9 49   9 53  21 50  21 58  126  128   27   28
 128  2  16 4   9 57   9 61  21 51  21 59  127  129   28   29
 129  2  16 5   9 50   9 54  21 52  21 60  128  130   29   30
 130  2  16 6   9 58   9 62  21 53  21 61  129  131   30   31
 131  2  16 7   9 51   9 55  21 54  21 62  130  132   31   32
 132  2  16 8   9 59   9 63  21 55  21 63  131  133   32   33

 133  2  17 1   9 64   9 68  20  0  20  8  132  134   33   34
 134  2  17 2   9 72   9 76  20  1  20  9  133  135   34   35
 135  2  17 3   9 65   9 69  20  2  20 10  134  136   35   36
 136  2  17 4   9 73   9 77  20  3  20 11  135  137   36   37
 137  2  17 5   9 66   9 70  20  4  20 12  136  138   37   38
 138  2  17 6   9 74   9 78  20  5  20 13  137  139   38   39
 139  2  17 7   9 67   9 71  20  6  20 14  138  140   39   40
 140  2  17 8   9 75   9 79  20  7  20 15  139  141   40   41

 141  2  18 1   9 80   9 84  20 16  20 24  140  142   41   42
 142  2  18 2   9 88   9 92  20 17  20 25  141  143   42   43
 143  2  18 3   9 81   9 85  20 18  20 26  142  144   43   44
 144  2  18 4   9 89   9 93  20 19  20 27  143  145   44   45
 145  2  18 5   9 82   9 86  20 20  20 28  144  146   45   46
 146  2  18 6   9 90   9 94  20 21  20 29  145  147   46   47
 147  2  18 7   9 83   9 87  20 22  20 30  146  148   47   48
 148  2  18 8   9 91   9 95  20 23  20 31  147  149   48   49

 149  2  19 1   8  0   8  4  20 32  20 40  148  150   49   50
 150  2  19 2   8  8   8 12  20 33  20 41  149  151   50   51
 151  2  19 3   8  1   8  5  20 34  20 42  150  152   51   52
 152  2  19 4   8  9   8 13  20 35  20 43  151  153   52   53
 153  2  19 5   8  2   8  6  20 36  20 44  152  154   53   54
 154  2  19 6   8 10   8 14  20 37  20 45  153  155   54   55
 155  2  19 7   8  3   8  7  20 38  20 46  154  156   55   56
 156  2  19 8   8 11   8 15  20 39  20 47  155  157   56   57

 157  2  20 1   8 16   8 20  20 48  20 56  156  158   57   58
 158  2  20 2   8 24   8 28  20 49  20 57  157  159   58   59
 159  2  20 3   8 17   8 21  20 50  20 58  158  160   59   60
 160  2  20 4   8 25   8 29  20 51  20 59  159  161   60   61
 161  2  20 5   8 18   8 22  20 52  20 60  160  162   61   62
 162  2  20 6   8 26   8 30  20 53  20 61  161  163   62   63
 163  2  20 7   8 19   8 23  20 54  20 62  162  164   63   64
 164  2  20 8   8 27   8 31  20 55  20 63  163  165   64   65

 165  2  21 1   8 32   8 36  19  0  19  8  164  166   65   66
 166  2  21 2   8 40   8 44  19  1  19  9  165  167   66   67
 167  2  21 3   8 33   8 37  19  2  19 10  166  168   67   68
 168  2  21 4   8 41   8 45  19  3  19 11  167  169   68   69
 169  2  21 5   8 34   8 38  19  4  19 12  168  170   69   70
 170  2  21 6   8 42   8 46  19  5  19 13  169  171   70   71
 171  2  21 7   8 35   8 39  19  6  19 14  170  172   71   72
 172  2  21 8   8 43   8 47  19  7  19 15  171  173   72   73

 173  2  22 1   8 48   8 52  19 16  19 24  172  174   73   74
 174  2  22 2   8 56   8 60  19 17  19 25  173  175   74   75
 175  2  22 3   8 49   8 53  19 18  19 26  174  176   75   76
 176  2  22 4   8 57   8 61  19 19  19 27  175  177   76   77
 177  2  22 5   8 50   8 54  19 20  19 28  176  178   77   78
 178  2  22 6   8 58   8 62  19 21  19 29  177  179   78   79
 179  2  22 7   8 51   8 55  19 22  19 30  178  180   79   80
 180  2  22 8   8 59   8 63  19 23  19 31  179  181   80   81

 181  2  23 1   8 64   8 68  19 32  19 40  180  182   81   82
 182  2  23 2   8 72   8 76  19 33  19 41  181  183   82   83
 183  2  23 3   8 65   8 69  19 34  19 42  182  184   83   84
 184  2  23 4   8 73   8 77  19 35  19 43  183  185   84   85
 185  2  23 5   8 66   8 70  19 36  19 44  184  186   85   86
 186  2  23 6   8 74   8 78  19 37  19 45  185  187   86   87
 187  2  23 7   8 67   8 71  19 38  19 46  186  188   87   88
 188  2  23 8   8 75   8 79  19 39  19 47  187  189   88   89

 189  2  24 1   8 80   8 84  19 48  19 56  188  190   89   90
 190  2  24 2   8 88   8 92  19 49  19 57  189  191   90   91
 191  2  24 3   8 81   8 85  19 50  19 58  190  192   91   92
 192  2  24 4   8 89   8 93  19 51  19 59  191  193   92   93
 193  2  24 5   8 82   8 86  19 52  19 60  192  194   93   94
 194  2  24 6   8 90   8 94  19 53  19 61  193  195   94   95
 195  2  24 7   8 83   8 87  19 54  19 62  194  196   95   96
 196  2  24 8   8 91   8 95  19 55  19 63  195  197   96   97
