#
# TWAL map for the s114 run in Fall '92
# cloned from S022 map with the following changes:
#	1. ADC's moved from 12,..,16 to 8,..12 (CsI moved to 2nd crate)
#
# FB layout:
#	slot	2222221111111111
#		54321098765432109876543210
#
#	type	CTTTTTTT     AAAAA   EBD  	C=CAT; T=TDC; A=ADC
#	det	 -----tof---------  		E=EBI; B=AEB; D=Display
#
# slot   module    used for
#  25    CAT
#  24    TDC       8pack  1... 4
#  23    TDC       8pack  5... 8
#  22    TDC       8pack  9...12
#  21    TDC       8pack 13...16
#  20    TDC       8pack 17...20
#  19    TDC       8pack 21...24
#  18    TDC       8pack 25, timing checks
#  ..    -
#  12    ADC       8pack  1... 6
#  11    ADC       8pack  7...12
#  10    ADC       8pack 13...18
#  09    ADC       8pack 19...24
#  08    ADC       8pack 25     
#  ..    -
#  04    EBI
#  03    AEB
#  02    FB display
#  01       
#  00       
#
# 8pack layout (beam going upwards) 
#
# in relative slat number space (slat numbers within 8pack)
#  back :    1   2   3   4   5   6   7   8 | 1   2   3   4   5   6   7   8 | ..
#  front:      8   7   6   5   4   3   2   1 | 8   7   6   5   4   3   2   1
#
# in absolute slat numbers:
#  back :   101 102 103 104 105 106 107 108|109 110 111 112 113 114 115 116| ..
#  front:      1   2   3   4   5   6   7   8 | 9  10  11  12  13  14  15  16
#
# Note: Mapping is regular except for a swap of the ADC channels
#       of slat (157:160) and (161:164)  [found and fixed 11-oct-91] 
#       of slat ( 89: 92) and (101:104)  [found and fixed 23-oct-91]
#
#   Phys.  slat   adct   adcb   tdct   tdcb  Neighbour's        slat
#    p  s         g  c   g  c   g  c   g  c    l    r   pl   pr type
#
# Note 2003-03-17:
#   To circumvent the 'channel 0' problems the first group of 16 channels
#   of each TDC was left unused. That required two additional TDC, which
#   were wired like:
#      24  0-15  ->  18  16-31
#      23  0-15  ->  18  32-47
#      22  0-15  ->  18  48-63
#      21  0-15  ->  17  16-31
#      20  0-15  ->  17  32-47
#      19  0-15  ->  17  48-63
#
# front layer
#
# ## typ pack   adct   adcb   tdct   tdcb    Neighbour's  
#         p s   g  c   g  c   g  c   g  c    l    r   pl   pr
#
   1  1   1 8  12 14  12 15  18 30  18 31    0    2  101  102
   2  1   1 7  12 12  12 13  18 28  18 29    1    3  102  103
   3  1   1 6  12 10  12 11  18 26  18 27    2    4  103  104
   4  1   1 5  12  8  12  9  18 24  18 25    3    5  104  105
   5  1   1 4  12  6  12  7  18 22  18 23    4    6  105  106
   6  1   1 3  12  4  12  5  18 20  18 21    5    7  106  107
   7  1   1 2  12  2  12  3  18 18  18 19    6    8  107  108
   8  1   1 1  12  0  12  1  18 16  18 17    7    9  108  109

   9  1   2 8  12 30  12 31  24 30  24 31    8   10  109  110
  10  1   2 7  12 28  12 29  24 28  24 29    9   11  110  111
  11  1   2 6  12 26  12 27  24 26  24 27   10   12  111  112
  12  1   2 5  12 24  12 25  24 24  24 25   11   13  112  113
  13  1   2 4  12 22  12 23  24 22  24 23   12   14  113  114
  14  1   2 3  12 20  12 21  24 20  24 21   13   15  114  115
  15  1   2 2  12 18  12 19  24 18  24 19   14   16  115  116
  16  1   2 1  12 16  12 17  24 16  24 17   15   17  116  117

  17  1   3 8  12 46  12 47  24 46  24 47   16   18  117  118
  18  1   3 7  12 44  12 45  24 44  24 45   17   19  118  119
  19  1   3 6  12 42  12 43  24 42  24 43   18   20  119  120
  20  1   3 5  12 40  12 41  24 40  24 41   19   21  120  121
  21  1   3 4  12 38  12 39  24 38  24 39   20   22  121  122
  22  1   3 3  12 36  12 37  24 36  24 37   21   23  122  123
  23  1   3 2  12 34  12 35  24 34  24 35   22   24  123  124
  24  1   3 1  12 32  12 33  24 32  24 33   23   25  124  125

  25  1   4 8  12 62  12 63  24 62  24 63   24   26  125  126
  26  1   4 7  12 60  12 61  24 60  24 61   25   27  126  127
  27  1   4 6  12 58  12 59  24 58  24 59   26   28  127  128
  28  1   4 5  12 56  12 57  24 56  24 57   27   29  128  129
  29  1   4 4  12 54  12 55  24 54  24 55   28   30  129  130
  30  1   4 3  12 52  12 53  24 52  24 53   29   31  130  131
  31  1   4 2  12 50  12 51  24 50  24 51   30   32  131  132
  32  1   4 1  12 48  12 49  24 48  24 49   31   33  132  133

  33  1   5 8  12 78  12 79  18 46  18 47   32   34  133  134
  34  1   5 7  12 76  12 77  18 44  18 45   33   35  134  135
  35  1   5 6  12 74  12 75  18 42  18 43   34   36  135  136
  36  1   5 5  12 72  12 73  18 40  18 41   35   37  136  137
  37  1   5 4  12 70  12 71  18 38  18 39   36   38  137  138
  38  1   5 3  12 68  12 69  18 36  18 37   37   39  138  139
  39  1   5 2  12 66  12 67  18 34  18 35   38   40  139  140
  40  1   5 1  12 64  12 65  18 32  18 33   39   41  140  141

  41  1   6 8  12 94  12 95  23 30  23 31   40   42  141  142
  42  1   6 7  12 92  12 93  23 28  23 29   41   43  142  143
  43  1   6 6  12 90  12 91  23 26  23 27   42   44  143  144
  44  1   6 5  12 88  12 89  23 24  23 25   43   45  144  145
  45  1   6 4  12 86  12 87  23 22  23 23   44   46  145  146
  46  1   6 3  12 84  12 85  23 20  23 21   45   47  146  147
  47  1   6 2  12 82  12 83  23 18  23 19   46   48  147  148
  48  1   6 1  12 80  12 81  23 16  23 17   47   49  148  149

  49  1   7 8  11 14  11 15  23 46  23 47   48   50  149  150
  50  1   7 7  11 12  11 13  23 44  23 45   49   51  150  151
  51  1   7 6  11 10  11 11  23 42  23 43   50   52  151  152
  52  1   7 5  11  8  11  9  23 40  23 41   51   53  152  153
  53  1   7 4  11  6  11  7  23 38  23 39   52   54  153  154
  54  1   7 3  11  4  11  5  23 36  23 37   53   55  154  155
  55  1   7 2  11  2  11  3  23 34  23 35   54   56  155  156
  56  1   7 1  11  0  11  1  23 32  23 33   55   57  156  157

  57  1   8 8  11 30  11 31  23 62  23 63   56   58  157  158
  58  1   8 7  11 28  11 29  23 60  23 61   57   59  158  159
  59  1   8 6  11 26  11 27  23 58  23 59   58   60  159  160
  60  1   8 5  11 24  11 25  23 56  23 57   59   61  160  161
  61  1   8 4  11 22  11 23  23 54  23 55   60   62  161  162
  62  1   8 3  11 20  11 21  23 52  23 53   61   63  162  163
  63  1   8 2  11 18  11 19  23 50  23 51   62   64  163  164
  64  1   8 1  11 16  11 17  23 48  23 49   63   65  164  165

  65  1   9 8  11 46  11 47  18 62  18 63   64   66  165  166
  66  1   9 7  11 44  11 45  18 60  18 61   65   67  166  167
  67  1   9 6  11 42  11 43  18 58  18 59   66   68  167  168
  68  1   9 5  11 40  11 41  18 56  18 57   67   69  168  169
  69  1   9 4  11 38  11 39  18 54  18 55   68   70  169  170
  70  1   9 3  11 36  11 37  18 52  18 53   69   71  170  171
  71  1   9 2  11 34  11 35  18 50  18 51   70   72  171  172
  72  1   9 1  11 32  11 33  18 48  18 49   71   73  172  173

  73  1  10 8  11 62  11 63  22 30  22 31   72   74  173  174
  74  1  10 7  11 60  11 61  22 28  22 29   73   75  174  175
  75  1  10 6  11 58  11 59  22 26  22 27   74   76  175  176
  76  1  10 5  11 56  11 57  22 24  22 25   75   77  176  177
  77  1  10 4  11 54  11 55  22 22  22 23   76   78  177  178
  78  1  10 3  11 52  11 53  22 20  22 21   77   79  178  179
  79  1  10 2  11 50  11 51  22 18  22 19   78   80  179  180
  80  1  10 1  11 48  11 49  22 16  22 17   79   81  180  181

  81  1  11 8  11 78  11 79  22 46  22 47   80   82  181  182
  82  1  11 7  11 76  11 77  22 44  22 45   81   83  182  183
  83  1  11 6  11 74  11 75  22 42  22 43   82   84  183  184
  84  1  11 5  11 72  11 73  22 40  22 41   83   85  184  185
  85  1  11 4  11 70  11 71  22 38  22 39   84   86  185  186
  86  1  11 3  11 68  11 69  22 36  22 37   85   87  186  187
  87  1  11 2  11 66  11 67  22 34  22 35   86   88  187  188
  88  1  11 1  11 64  11 65  22 32  22 33   87   89  188  189

  89  1  12 8  11 94  11 95  22 62  22 63   88   90  189  190
  90  1  12 7  11 92  11 93  22 60  22 61   89   91  190  191
  91  1  12 6  11 90  11 91  22 58  22 59   90   92  191  192
  92  1  12 5  11 88  11 89  22 56  22 57   91   93  192  193
  93  1  12 4  11 86  11 87  22 54  22 55   92   94  193  194
  94  1  12 3  11 84  11 85  22 52  22 53   93   95  194  195
  95  1  12 2  11 82  11 83  22 50  22 51   94   96  195  196
  96  1  12 1  11 80  11 81  22 48  22 49   95    0  196    0
#
# back layer
#
 101  2  13 1  10  0  10  1  17 16  17 17    0  102    0    1
 102  2  13 2  10  2  10  3  17 18  17 19  101  103    1    2
 103  2  13 3  10  4  10  5  17 20  17 21  102  104    2    3
 104  2  13 4  10  6  10  7  17 22  17 23  103  105    3    4
 105  2  13 5  10  8  10  9  17 24  17 25  104  106    4    5
 106  2  13 6  10 10  10 11  17 26  17 27  105  107    5    6
 107  2  13 7  10 12  10 13  17 28  17 29  106  108    6    7
 108  2  13 8  10 14  10 15  17 30  17 31  107  109    7    8

 109  2  14 1  10 16  10 17  21 16  21 17  108  110    8    9
 110  2  14 2  10 18  10 19  21 18  21 19  109  111    9   10
 111  2  14 3  10 20  10 21  21 20  21 21  110  112   10   11
 112  2  14 4  10 22  10 23  21 22  21 23  111  113   11   12
 113  2  14 5  10 24  10 25  21 24  21 25  112  114   12   13
 114  2  14 6  10 26  10 27  21 26  21 27  113  115   13   14
 115  2  14 7  10 28  10 29  21 28  21 29  114  116   14   15
 116  2  14 8  10 30  10 31  21 30  21 31  115  117   15   16

 117  2  15 1  10 32  10 33  21 32  21 33  116  118   16   17
 118  2  15 2  10 34  10 35  21 34  21 35  117  119   17   18
 119  2  15 3  10 36  10 37  21 36  21 37  118  120   18   19
 120  2  15 4  10 38  10 39  21 38  21 39  119  121   19   20
 121  2  15 5  10 40  10 41  21 40  21 41  120  122   20   21
 122  2  15 6  10 42  10 43  21 42  21 43  121  123   21   22
 123  2  15 7  10 44  10 45  21 44  21 45  122  124   22   23
 124  2  15 8  10 46  10 47  21 46  21 47  123  125   23   24

 125  2  16 1  10 48  10 49  21 48  21 49  124  126   24   25
 126  2  16 2  10 50  10 51  21 50  21 51  125  127   25   26
 127  2  16 3  10 52  10 53  21 52  21 53  126  128   26   27
 128  2  16 4  10 54  10 55  21 54  21 55  127  129   27   28
 129  2  16 5  10 56  10 57  21 56  21 57  128  130   28   29
 130  2  16 6  10 58  10 59  21 58  21 59  129  131   29   30
 131  2  16 7  10 60  10 61  21 60  21 61  130  132   30   31
 132  2  16 8  10 62  10 63  21 62  21 63  131  133   31   32

 133  2  17 1  10 64  10 65  17 32  17 33  132  134   32   33
 134  2  17 2  10 66  10 67  17 34  17 35  133  135   33   34
 135  2  17 3  10 68  10 69  17 36  17 37  134  136   34   35
 136  2  17 4  10 70  10 71  17 38  17 39  135  137   35   36
 137  2  17 5  10 72  10 73  17 40  17 41  136  138   36   37
 138  2  17 6  10 74  10 75  17 42  17 43  137  139   37   38
 139  2  17 7  10 76  10 77  17 44  17 45  138  140   38   39
 140  2  17 8  10 78  10 79  17 46  17 47  139  141   39   40

 141  2  18 1  10 80  10 81  20 16  20 17  140  142   40   41
 142  2  18 2  10 82  10 83  20 18  20 19  141  143   41   42
 143  2  18 3  10 84  10 85  20 20  20 21  142  144   42   43
 144  2  18 4  10 86  10 87  20 22  20 23  143  145   43   44
 145  2  18 5  10 88  10 89  20 24  20 25  144  146   44   45
 146  2  18 6  10 90  10 91  20 26  20 27  145  147   45   46
 147  2  18 7  10 92  10 93  20 28  20 29  146  148   46   47
 148  2  18 8  10 94  10 95  20 30  20 31  147  149   47   48

 149  2  19 1   9  0   9  1  20 32  20 33  148  150   48   49
 150  2  19 2   9  2   9  3  20 34  20 35  149  151   49   50
 151  2  19 3   9  4   9  5  20 36  20 37  150  152   50   51
 152  2  19 4   9  6   9  7  20 38  20 39  151  153   51   52
 153  2  19 5   9  8   9  9  20 40  20 41  152  154   52   53
 154  2  19 6   9 10   9 11  20 42  20 43  153  155   53   54
 155  2  19 7   9 12   9 13  20 44  20 45  154  156   54   55
 156  2  19 8   9 14   9 15  20 46  20 47  155  157   55   56

 157  2  20 1   9 16   9 17  20 48  20 49  156  158   56   57
 158  2  20 2   9 18   9 19  20 50  20 51  157  159   57   58
 159  2  20 3   9 20   9 21  20 52  20 53  158  160   58   59
 160  2  20 4   9 22   9 23  20 54  20 55  159  161   59   60
 161  2  20 5   9 24   9 25  20 56  20 57  160  162   60   61
 162  2  20 6   9 26   9 27  20 58  20 59  161  163   61   62
 163  2  20 7   9 28   9 29  20 60  20 61  162  164   62   63
 164  2  20 8   9 30   9 31  20 62  20 63  163  165   63   64

 165  2  21 1   9 32   9 33  17 48  17 49  164  166   64   65
 166  2  21 2   9 34   9 35  17 50  17 51  165  167   65   66
 167  2  21 3   9 36   9 37  17 52  17 53  166  168   66   67
 168  2  21 4   9 38   9 39  17 54  17 55  167  169   67   68
 169  2  21 5   9 40   9 41  17 56  17 57  168  170   68   69
 170  2  21 6   9 42   9 43  17 58  17 59  169  171   69   70
 171  2  21 7   9 44   9 45  17 60  17 61  170  172   70   71
 172  2  21 8   9 46   9 47  17 62  17 63  171  173   71   72

 173  2  22 1   9 48   9 49  19 16  19 17  172  174   72   73
 174  2  22 2   9 50   9 51  19 18  19 19  173  175   73   74
 175  2  22 3   9 52   9 53  19 20  19 21  174  176   74   75
 176  2  22 4   9 54   9 55  19 22  19 23  175  177   75   76
 177  2  22 5   9 56   9 57  19 24  19 25  176  178   76   77
 178  2  22 6   9 58   9 59  19 26  19 27  177  179   77   78
 179  2  22 7   9 60   9 61  19 28  19 29  178  180   78   79
 180  2  22 8   9 62   9 63  19 30  19 31  179  181   79   80

 181  2  23 1   9 64   9 65  19 32  19 33  180  182   80   81
 182  2  23 2   9 66   9 67  19 34  19 35  181  183   81   82
 183  2  23 3   9 68   9 69  19 36  19 37  182  184   82   83
 184  2  23 4   9 70   9 71  19 38  19 39  183  185   83   84
 185  2  23 5   9 72   9 73  19 40  19 41  184  186   84   85
 186  2  23 6   9 74   9 75  19 42  19 43  185  187   85   86
 187  2  23 7   9 76   9 77  19 44  19 45  186  188   86   87
 188  2  23 8   9 78   9 79  19 46  19 47  187  189   87   88

 189  2  24 1   9 80   9 81  19 48  19 49  188  190   88   89
 190  2  24 2   9 82   9 83  19 50  19 51  189  191   89   90
 191  2  24 3   9 84   9 85  19 52  19 53  190  192   90   91
 192  2  24 4   9 86   9 87  19 54  19 55  191  193   91   92
 193  2  24 5   9 88   9 89  19 56  19 57  192  194   92   93
 194  2  24 6   9 90   9 91  19 58  19 59  193  195   93   94
 195  2  24 7   9 92   9 93  19 60  19 61  194  196   94   95
 196  2  24 8   9 94   9 95  19 62  19 63  195    0   95   96

#201  3  25 1   8  0   8  1  18  0  18  1    0    0    0    0
#202  3  25 2   8  2   8  3  18  2  18  3    0    0    0    0
#203  3  25 3   8  4   8  5  18  4  18  5    0    0    0    0
#204  3  25 4   8  6   8  7  18  6  18  7    0    0    0    0
#205  3  25 5   8  8   8  9  18  8  18  9    0    0    0    0
#206  3  25 6   8 10   8 11  18 10  18 11    0    0    0    0
#207  3  25 7   8 12   8 13  18 12  18 13    0    0    0    0
#208  3  25 8   8 14   8 15  18 14  18 15    0    0    0    0
